########
#P     #
#      #
#      #
#     G#
########